#Other maze option.

maze = [
    ["#", "#", "O", "#", "#", "#", "#", "#", "#"],
    ["#", " ", " ", " ", " ", " ", " ", " ", "#"],
    ["#", " ", "#", "#", " ", "#", "#", " ", "#"],
    ["#", " ", "#", " ", " ", " ", "#", " ", "#"],
    ["#", " ", "#", " ", "#", " ", "#", " ", "#"],
    ["#", " ", "#", " ", "#", " ", "#", " ", "#"],
    ["#", " ", "#", " ", "#", " ", "#", "#", "#"],
    ["#", " ", " ", " ", "#", " ", "#", " ", "#"],
    ["#", "#", "#", "#", "#", " ", "#", " ", "#"],
    ["#", " ", " ", " ", " ", " ", "#", " ", "#"],
    ["#", "#", "#", " ", "#", "#", "#", " ", "#"],
    ["#", " ", " ", " ", " ", " ", " ", " ", "#"],
    ["#", " ", "#", "#", " ", "#", "#", " ", "#"],
    ["#", " ", "#", " ", " ", " ", "#", " ", "#"],
    ["#", "#", "#", "#", "#", "#", "#", "X", "#"]
]
